1BBB1BBBBBB
B2222222222
B3333B33333
B4444B44444
B5555555B55
BBBBB666666
77777777777
88888888888
99999999999
AAAAAAAAAAA
BBBBbbbbbbb
cccccccBBBB
