1BBBBBBBBBB
B2222222222
B3333333333
B4444444444
B5555555555
