11111111111
22222222222
3333B333333
44444444444
5555B555555
66666666666
7777B777777
88888888888
9999B999999
AAAAAAAAAAA
bbbbBbbbbbb
ccccccccccc
